W0 W0 W0 W0 W0 W0 W0 W0 W0 W0 W0 W0 W0 W0 W0 W0 W0 W0 W0 W0 W0 W0 W0 W0 W0 W0 W0 W0 W0 W0 W0 W0
W0 F0 F0 F0 F0 F0 W0 F0 F0 F0 F0 F0 F0 F0 W0 F0 F0 F0 F0 F0 F0 F0 F0 F0 F0 F0 F0 F0 F0 F0 F0 W0
W0 F0 F0 F0 F0 F0 F0 F0 F0 F0 F0 F0 F0 F0 W0 F0 F0 F0 F0 F0 F0 F0 F0 F0 F0 F0 F0 F0 F0 F0 F0 W0
W0 F0 F0 F0 F0 F0 F0 F0 F0 F0 F0 F0 F0 F0 F0 F0 F0 F0 F0 F0 F0 F0 W0 F0 F0 F0 F0 F0 F0 F0 F0 W0
W0 F0 F0 F0 F0 F0 W0 F0 F0 F0 F0 F0 F0 F0 F0 F0 F0 F0 F0 F0 F0 F0 W0 F0 F0 F0 F0 F0 F0 F0 F0 W0
W0 W0 F0 F0 W0 W0 W0 W0 W0 W0 W0 W0 W0 W0 W0 W0 W0 W0 W0 W0 W0 W0 W0 W0 W0 W0 W0 W0 F0 F0 F0 W0
W0 F0 F0 F0 F0 F0 W0 F0 F0 F0 F0 F0 F0 F0 F0 F0 F0 F0 F0 F0 F0 F0 W0 F0 F0 F0 F0 W0 F0 F0 F0 W0
W0 F0 F0 F0 F0 F0 F0 F0 F0 F0 F0 F0 F0 F0 F0 F0 F0 F0 F0 F0 F0 F0 F0 F0 F0 F0 F0 F0 F0 F0 F0 W0
W0 F0 F0 F0 F0 F0 F0 F0 F0 F0 F0 F0 F0 F0 F0 F0 F0 F0 F0 F0 F0 F0 F0 F0 F0 F0 F0 F0 F0 F0 F0 W0
W0 F0 F0 F0 F0 F0 W0 F0 F0 F0 W0 W0 W0 W0 W0 F0 F0 F0 F0 F0 F0 F0 F0 F0 F0 F0 F0 F0 F0 F0 F0 W0
W0 F0 F0 F0 F0 F0 W0 F0 F0 F0 W0 F0 F0 F0 W0 F0 F0 F0 F0 F0 F0 F0 W0 F0 F0 F0 F0 W0 F0 F0 F0 W0
W0 W0 F0 F0 W0 W0 W0 W0 W0 W0 W0 F0 F0 F0 W0 W0 W0 W0 W0 W0 W0 W0 W0 F0 F0 F0 F0 W0 W0 W0 W0 W0
W0 F0 F0 F0 F0 F0 F0 F0 F0 F0 F0 F0 F0 F0 F0 F0 F0 F0 F0 F0 F0 F0 W0 F0 F0 F0 F0 W0 F0 F0 F0 W0
W0 F0 F0 F0 F0 F0 F0 F0 F0 F0 F0 F0 F0 F0 F0 F0 F0 F0 F0 F0 F0 F0 W0 F0 F0 F0 F0 W0 F0 F0 F0 W0
W0 F0 F0 F0 F0 F0 W0 F0 F0 F0 F0 F0 F0 F0 F0 F0 F0 F0 W0 F0 F0 F0 W0 W0 F0 F0 W0 W0 F0 F0 F0 W0
W0 F0 F0 F0 F0 F0 W0 W0 W0 W0 W0 W0 W0 W0 W0 W0 W0 W0 W0 F0 F0 F0 W0 F0 F0 F0 F0 W0 F0 F0 F0 W0
W0 F0 F0 F0 F0 F0 W0 F0 F0 F0 F0 F0 F0 F0 F0 F0 F0 F0 W0 F0 F0 F0 F0 F0 F0 F0 F0 F0 F0 F0 F0 W0
W0 F0 F0 F0 F0 F0 F0 F0 F0 F0 F0 F0 F0 F0 F0 F0 F0 F0 F0 F0 F0 F0 F0 F0 F0 F0 F0 F0 F0 F0 F0 W0
W0 F0 F0 F0 F0 F0 F0 F0 F0 F0 F0 F0 F0 F0 F0 F0 F0 F0 F0 F0 F0 F0 W0 F0 F0 F0 F0 W0 F0 F0 F0 W0
W0 W0 F0 F0 W0 W0 W0 W0 W0 W0 W0 F0 F0 F0 W0 W0 W0 W0 W0 W0 W0 W0 W0 F0 F0 F0 F0 W0 W0 W0 W0 W0
W0 F0 F0 F0 F0 F0 W0 F0 F0 F0 W0 F0 F0 F0 W0 F0 F0 F0 W0 F0 F0 F0 W0 F0 F0 F0 F0 W0 F0 F0 F0 W0
W0 F0 F0 F0 F0 F0 W0 F0 F0 F0 W0 W0 W0 W0 W0 F0 F0 F0 W0 F0 F0 F0 W0 W0 F0 F0 W0 W0 F0 F0 F0 W0
W0 F0 F0 F0 F0 F0 F0 F0 F0 F0 F0 F0 F0 F0 F0 F0 F0 F0 F0 F0 F0 F0 F0 F0 F0 F0 F0 F0 F0 F0 F0 W0
W0 F0 F0 F0 F0 F0 F0 F0 F0 F0 F0 F0 F0 F0 F0 F0 F0 F0 F0 F0 F0 F0 F0 F0 F0 F0 F0 F0 F0 F0 F0 W0
W0 F0 F0 F0 F0 F0 W0 F0 F0 F0 F0 F0 F0 F0 F0 F0 F0 F0 W0 F0 F0 F0 F0 F0 F0 F0 F0 F0 F0 F0 F0 W0
W0 F0 F0 F0 F0 F0 W0 F0 F0 F0 F0 F0 F0 F0 F0 F0 F0 F0 W0 F0 F0 F0 F0 F0 F0 F0 F0 F0 F0 F0 F0 W0
W0 W0 F0 F0 W0 W0 W0 W0 W0 W0 W0 W0 W0 W0 W0 W0 W0 W0 W0 W0 W0 W0 W0 W0 W0 W0 W0 W0 F0 F0 W0 W0
W0 F0 F0 F0 F0 F0 W0 F0 F0 F0 F0 F0 F0 F0 F0 F0 F0 F0 W0 F0 F0 F0 F0 F0 F0 F0 F0 F0 F0 F0 F0 W0
W0 F0 F0 F0 F0 F0 W0 F0 F0 F0 F0 F0 F0 F0 F0 F0 F0 F0 W0 F0 F0 F0 F0 F0 F0 F0 F0 F0 F0 F0 F0 W0
W0 F0 F0 F0 F0 F0 F0 F0 F0 F0 F0 F0 W0 F0 F0 F0 F0 F0 F0 F0 F0 F0 F0 W0 F0 F0 F0 F0 F0 F0 F0 W0
W0 F0 F0 F0 F0 F0 F0 F0 F0 F0 F0 F0 W0 F0 F0 F0 F0 F0 F0 F0 F0 F0 F0 W0 F0 F0 F0 F0 F0 F0 F0 W0
W0 W0 W0 W0 W0 W0 W0 W0 W0 W0 W0 W0 W0 W0 W0 W0 W0 W0 W0 W0 W0 W0 W0 W0 W0 W0 W0 W0 W0 W0 W0 W0